################################################ #
#  #############                      ############
## ################################## ########## #
##                                           #####
## ######################## ################ ### #
## ######################## ################ #####
## ######################## ######               #
##             ############ ##################   #
############## #######      #################    #
############## ################################  #
##   ######### ################# #################
##       ##### ################# #########       #
###   ######## ################# ##########      #
###   ######## ################# ########### #####
###       ####                         ###### ####
###################################### ####### ###
###################################### ######## ##
######################################   #########
########################################        F#
##################################################
