################################################ #
#S                                    ############
## ################################## ########## #
##                                           #####
## ######################## ################ ### #
## #####             ###### ################ #####
## ################# ###### ######               #
##             ##### ###### ##################   #
############## ##### #      ########       ##    #
############## ##### ############### ####  ####  #
##   ######### ##### ########### ### #### ###### #
##       ##### ##### ########### ### #####       #
###   ######## ##### ########### ### ######      #
###   ######## ##### ########### ### #######  ####
###       ####         #               ######  ###
####### ###############                #######  ##
#######                  ###########   ######## ##
######################################   ###### ##
########################################        F#
##################################################
##################################################
##################################################
##################################################
##################################################
##################################################
##################################################
##################################################
##################################################
##################################################
##################################################
##################################################
##################################################
##################################################
##################################################
##################################################
##################################################
##################################################
##################################################
##################################################
##################################################
##################################################
##################################################
##################################################
##################################################
##################################################
##################################################
