S ############################################## #
   ###############################################
## ############################################# #
##                                       #########
## ######################## #################### #
## ######################## ######################
## ######################## ######        #####  #
##             ############ ##################   #
############## ##############################    #
############## #############################     #
##   ######### ################# ##########      #
##       ##### ################# #########       #
###   ######## ################# ##########      #
###   ######## ################# ########### #####
###       ####                         ###### ####
###################################### ####### ###
###################################### ######## ##
###################################### F #########
########################################         #
##################################################
