S ###############################    #############
  #######   ######## ###########      ############
# ################################################
# ################################################
# ################## #############################
# ################################################
# ################################################
# ################################################
# #######     ####################     ###########
# #######    #####################################
# ############################     ###############
# ####### ######################## ##### #########
# ####### ##### ######################## #########
#                    ################### #########
############### #                 ##     #########
#################      #          ################
################################# ################
#################### ############ ## #############
################################# ################
############################ ####                F
