S ################################################
                      ############################
## ################## ############################
##                                       #########
## ################################### ###########
## ######################## ########## ###########
## ######################## ######        ########
##             ############ ###### ###############
#### ######### ################### ###############
#### ###########################   ###############
##   ######### ######    ####### #################
##       ##### ####### ######### #################
###   ######## ####### ######### #################
###   ######## ####### ######### #################
###       ####                         ###########
###################################### ###########
###################################### ###########
######################################   #########
########################################          
################################################ F
