S ################################################
   ###############################################
## ###############################################
##                                       #########
## ######################## ######################
## ######################## ######################
## ######################## ######        ########
##             ############ ######################
############## ###################################
############## ###################################
##   ######### ################# #################
##       ##### ################# #################
###   ######## ################# #################
###   ######## ################# #################
###       ####                         ###########
###################################### ###########
###################################### ###########
######################################   #########
########################################          
################################################ F
