S ################################################
#  ###############################################
## ###############################################
## ###############################################
## ###############################################
## ###############################################
## ###############################################
##             ###################################
############## ###################################
############## ###################################
############## ###################################
############## ###################################
############## ###################################
############## ###################################
##############                         ###########
###################################### ###########
###################################### ###########
######################################   #########
########################################      
#################################################F
