S ################################################
#  ###############################################
## ###############################################
##                                       #########
## ######################## ######################
## ######################## ######################
## ######################## ######################
##             ############ ######################
############## ###################################
############## ###################################
############## ################# #################
############## ################# #################
############## ################# #################
############## ################# #################
##############                         ###########
###################################### ###########
###################################### ###########
######################################   #########
########################################      
#################################################F
